#
# 0 D room1.txt 2
#
W1WWWWWWWW
W        W
W        W
W WWW    W
W   W    W
W   W  WWW
W        W
W  WW    W
W       HW
W1WWWWWWWW
